lychee		/’li:tʃi:/	vải
strawberry	/ˈstrɔ:bəri/	dâu tây
persimmon	/pə´simən/	hồng
tamarind	/’tæmərind/	trái me 
malay apple	/mə’lei ‘æpl/	trái mận  
star apple	/’stɑ:r ‘æpl/	vú sữa
chestnut	/´tʃestnʌt/	hạt dẻ
blackberry	/ˈblakb(ə)ri/	mâm xôi đen
ambarella	/’æmbə’rælə/	cóc
starfruit	/’stɑ:r.fru:t/	khế
mangosteen	/ˈmaŋgəstiːn/	măng cụt
mandarin 	/’mændərin/	quýt
soursop		/’sɔ:sɔp/	mãng cầu xiêm
custard-apple	/’kʌstəd,æpl/	mãng cầu na
apricot		/ˈæ.prɪ.kɒt/	mơ
sapota		/sə’poutə/	sapôchê
pomegranate	/´pɔm¸grænit/	lựu
date		/deit/		quả chà là
passion-fruit	/´pæʃən¸fru:t/	chanh dây
jujube		/´dʒu:dʒu:b/	táo tàu 
kumquat 	/ˈkəmˌkwät/	Tắc
star gooseberry	/’stɑ:r ’guzbəri/	Tầm ruộc
sugar cane 	/’ʃugə kein/	Mía
cherry 		/'t∫eri/ 	Anh Đào
raspberry	/ˈræz.ˌbɛr.i/	Quả mâm xôi
